[domainSet]
ClothesHanger=晾衣机
GasValve=燃气阀
MagneticValve=电磁阀
RollingShutterDoor=卷帘门
Dev.sweepingRobot=扫地机器人
MassageChair=按摩椅
CoffeeMachine=咖啡机
CookingStove=灶具
Gateway=网关
SmartDoor=智能门
BathRoomMaster=浴霸
Dev.oven=烤箱
Oxygenerator=制氧机
Dev.purifier=空气净化器
ElectricWindows=电动窗户
ElectronicGate=电动门
SmartPlug=智能插座
SmartSwitch=智能开关
Sterilizer=消毒柜
TranslucentScreen=投影幕
WindowPusher=推窗器
Sunshade=遮阳棚
AirFreshMachine=新风机
Dev.airConditioner=空调
Dehumidifier=除湿机
Fan=风扇
Humidifier=加湿机
WaterPurifier=净水机
Lamp=灯
Dishwasher=洗碗机
DrinksCabinet=酒柜
Freezer=冷柜
IceBar=冰吧
IntegratedStove=集成灶
SteamBaker=蒸烤箱
Steamer=蒸箱
WallBreakingMachine=破壁机
Dev.scene=场景
Dev.TV=电视
LiangBa=凉霸
RiceCooker=电饭煲
Dryer=干衣机
TowelRack=毛巾架
Dev.washer=洗衣机
MusicBox=音箱
ElectricHeater=电暖器
Furnace=采暖炉
SmartBed=智能床
HeatPump=热泵
MagicMirror=魔镜
Dev.cookHood=油烟机
Fridge=冰箱
Dev.heater=电热
Dev.heaterGas=燃热
AirDetector=空气检测仪
DispersionMachine=弥散机
ElectricHeatingTable=电暖桌
Commode=马桶
NursingMachine=护理机
PipelineMachine=管线机
BackgroundMusic=背景音乐
Prefilter=前置净水机
Ventilator=排风扇
WindowCurtains=窗帘
vegetableManagement=食材管理
WineCollocation=食材推荐

